111111111111111111111111
100000000011000100001001
100100000011000100001001
1001000000000W0000000001
100100000011000100001001
100000000011000100001001
100100000011000100001001
111111111111111111111111