R 1600 900
NO ./textures/widk.xpm
SO ./textures/woodwall.xpm
WE ./textures/wstone.xpm
EA ./textures/wall1v.xpm

S ./textures/5.xpm
F 220,100,0
C 110,100,208

111111111111111111111111
100000000011000100001001
1N0102000011000100001001
100100000000000000000001
100100000011000100001001
100000000011000100201001
100100000011000100001001
111111111111111111111111