R 1600 900
NO ./textures/widk.xpm
SO ./textures/4.xpm
WE ./textures/wall1v.xpm
EA ./textures/wstone.xpm
S ./textures/Tree.xpm

F 220,100,0
C 110,100,208

111111111111111111111111111111111111111111111111
100E00000000000000000020000000000000000000002001
10000000000020000000000000000000200000000000001
111001111111111111111111111111111111111111111111
100000000011000100001001
100000000011000111111111
10010000001100011
11111111111111111