R 1600 900
NO ./textures/woodwall.xpm
SO ./textures/widk.xpm
WE ./textures/wstone.xpm
EA ./textures/wall1v.xpm

S ./textures/5.xpm
F 220,100,0
C 110,100,208

111111111111111111111111
100000000011000100001001
1N0100000011000100001001
100100002000000000000001
100100000011000100001001
100000000011000100001001
100100000011000100001001
111111111111111111111111