R 1600 900
NO ./textures/woodwall.xpm
SO ./textures/widk.xpm
WE ./textures/wall1v.xpm
EA ./textures/wall1v.xpm

S ./textures/wstone.xpm
F 220,100,0
C 110,100,208

111111111111111111111111
120000000011000102001001
100100000011000100001001
1001E0002000000000000001
100100020011000100001001
100000000011200100001001
102100000011000100001001
111111111111111111111111