R 1600 900
NO ./textures/widk.xpm
SO ./textures/woodwall.xpm
WE ./textures/wstone.xpm
EA ./textures/wall1v.xpm

S ./path_to_the_sprite_texture
F 220,100,0
C 110,100,208

111111111111111111111111
100202000011000100001001
100102000011000100001001
1001000000E0000000000001
100100000011000100001001
100000000011000100201001
100100000011000100001001
111111111111111111111111