R 1600 900
NO ./textures/woodwall.xpm
SO ./textures/widk.xpm
WE ./textures/wall1v.xpm
EA ./textures/wall1v.xpm

S ./textures/wstone.xpm
F 220,100,0
C 110,100,208

111111111111111111111111
100000000011000100001001
100100000011000100001001
1001E0020002000000000201
100100000011000100001001
100000000011000100001001
100100000011000100001001
111111111111111111111111