R 1600 900
NO ./textures/widk.xpm
SO ./textures/woodwall.xpm
WE ./textures/wstone.xpm
EA ./textures/wall1v.xpm

S ./textures/5.xpm
F 220,100,0
C 110,100,208

1111111
1200W01
1000001
1111111