R 1600 900
NO ./textures/woodwall.xpm
SO ./textures/widk.xpm
WE ./textures/wall1v.xpm
EA ./textures/wstone.xpm

S ./textures/5.xpm
F 220,100,0
C 110,100,208

111111111111111111111111111111111111111111111111
100N00000000000000000020000000000000000000002001
100000000000020000000000000000000200000000000001
111111111111111111111111111111111111111111111111
100100000011000100001001
100000000011000100001001
100100000011000100001001
111111111111111111111111